1.01579  2.99997  2.88278  1.0126  3  
1  1  1  1  1.0038  
1  1.6606  1  1  1  
1.01152  2.74952  2.78123  1.01271  1  
1  3  1  1  1  
1.01152  2.74952  2.78123  1.01271  1  
1  2.71492  1  1  1  
1  3  1  1  1  
1  2.74952  1  1  1  
1.01152  2.74952  2.78123  1.01271  1  
1  2.30605  1  1  1  
1  2.79125  1  1  1  
1  2.40935  1  1  1  
1  3  1  1  1  
1  2.187  1  1  1  
1  2.82557  1  1  1  
1  2.36095  1  1  1  
1.01152  2.74952  2.78123  1.01271  1  
1  1.76173  1  1  1.11576  
1  2.37337  1  1  1  
1  2.03705  1  1  1  
1  2.84691  1  1  1  
1  1.87271  1  1  1  
1  2.45912  1  1  1  
1  2.04019  1  1  1  
1  3  1  1  1  
1  1.72916  1  1  1  
1  2.21439  1  1  1  
1  1.86849  1  1  1  
1  2.84094  1  1  1  
1  1.72222  1  1  1  
1  2.3649  1  1  1  
1  1.90278  1  1  1  
1.01152  2.74952  2.78123  1.01271  1  
1  1.24539  1  1  1.18117  
1  1.89099  1  1  1  
1  1.63757  1  1  1  
1  2.33625  1  1  1  
1  1.53083  1  1  1  
1  1.98953  1  1  1  
1  1.65971  1  1  1  
1  2.78278  1  1  1  
1  1.44515  1  1  1  
1  1.80325  1  1  1  
1  1.54631  1  1  1  
1  2.35705  1  1  1  
1  1.44755  1  1  1  
1  1.93237  1  1  1  
1  1.57649  1  1  1  
1  3  1  1  1  
1  1.33966  1  1  1  
1  1.61585  1  1  1  
1  1.41635  1  1  1  
1  2.04259  1  1  1  
1  1.33937  1  1  1  
1  1.70807  1  1  1  
1  1.43545  1  1  1  
1  2.62162  1  1  1  
1  1.27923  1  1  1  
1  1.55035  1  1  1  
1  1.35051  1  1  1  
1  2.09262  1  1  1  
1  1.27922  1  1  1  
1  1.66174  1  1  1  
1  1.37004  1  1  1  
1  3  1  1  1  
1  1  1  1  1.11204  
1  1.34612  1  1  1  
1  1.22995  1  1  1  
1  1.58551  1  1  1  
1  1.18344  1  1  1  
1  1.38374  1  1  1  
1  1.23112  1  1  1  
1  1.8802  1  1  1  
1  1.14388  1  1  1  
1  1.28139  1  1  1  
1  1.17571  1  1  1  
1  1.54513  1  1  1  
1  1.1351  1  1  1  
1  1.31513  1  1  1  
1  1.17206  1  1  1  
1  2.09098  1  1  1  
1  1.09009  1  1  1  
1  1.17047  1  1  1  
1  1.10532  1  1  1  
1  1.30563  1  1  1  
1  1.07739  1  1  1  
1  1.17092  1  1  1  
1  1.09195  1  1  1  
1  1.48789  1  1  1  
1  1.04943  1  1  1  
1  1.09723  1  1  1  
1  1.05308  1  1  1  
1  1.18983  1  1  1  
1  1.03235  1  1  1  
1  1.07319  1  1  1  
1  1.02996  1  1  1  
1  1.41132  1  1  1  
1  1.00683  1  1  1  
1  1.00462  1  1  1  
1.00073  3  2.91807  1.00086  3  
1  1  1  1.00001  1.00414  
1  1.68573  1  1  1  
1  3  2.39886  1  1  
1  3  1  1  1  
1  2.99998  2.28068  1  1  
1  2.78018  1  1  1  
1  3  1  1  1  
1  2.81609  1  1  1  
1  3  2.33433  1  1  
1  2.35574  1  1  1  
1  2.85941  1  1  1  
1  2.46299  1  1  1  
1  3  1  1  1  
1  2.23217  1  1  1  
1  2.89504  1  1  1  
1  2.41273  1  1  1  
1  3  2.38951  1  1  
1  1.79265  1  1  1.11868  
1  2.42564  1  1  1  
1  2.07651  1  1  1  
1  2.91719  1  1  1  
1  1.90591  1  1  1  
1  2.51464  1  1  1  
1  2.07977  1  1  1  
1  3  1  1  1  
1  1.7569  1  1  1  
1  2.26059  1  1  1  
1  1.90155  1  1  1  
1  2.91099  1  1  1  
1  1.7497  1  1  1  
1  2.41684  1  1  1  
1  1.93713  1  1  1  
1  2.99999  2.38309  1  1  
1  1.24939  1  1  1.19741  
1  1.92489  1  1  1  
1  1.66184  1  1  1  
1  2.3871  1  1  1  
1  1.55103  1  1  1  
1  2.02717  1  1  1  
1  1.68481  1  1  1  
1  2.8506  1  1  1  
1  1.46209  1  1  1  
1  1.83381  1  1  1  
1  1.56709  1  1  1  
1  2.40869  1  1  1  
1  1.46457  1  1  1  
1  1.96786  1  1  1  
1  1.59842  1  1  1  
1  3  1  1  1  
1  1.35257  1  1  1  
1  1.63928  1  1  1  
1  1.43219  1  1  1  
1  2.08226  1  1  1  
1  1.35228  1  1  1  
1  1.73502  1  1  1  
1  1.45202  1  1  1  
1  2.68334  1  1  1  
1  1.28985  1  1  1  
1  1.57129  1  1  1  
1  1.36384  1  1  1  
1  2.13419  1  1  1  
1  1.28984  1  1  1  
1  1.68692  1  1  1  
1  1.38412  1  1  1  
1  3  2.07761  1  1  
1  1  1  1.0001  1.11931  
1  1.35928  1  1  1  
1  1.23869  1  1  1  
1  1.60779  1  1  1  
1  1.19042  1  1  1  
1  1.39834  1  1  1  
1  1.2399  1  1  1  
1  1.91369  1  1  1  
1  1.14935  1  1  1  
1  1.29209  1  1  1  
1  1.18238  1  1  1  
1  1.56587  1  1  1  
1  1.14024  1  1  1  
1  1.32711  1  1  1  
1  1.1786  1  1  1  
1  2.13248  1  1  1  
1  1.09351  1  1  1  
1  1.17694  1  1  1  
1  1.10932  1  1  1  
1  1.31726  1  1  1  
1  1.08033  1  1  1  
1  1.17742  1  1  1  
1  1.09544  1  1  1  
1  1.50645  1  1  1  
1  1.0513  1  1  1  
1  1.10092  1  1  1  
1  1.05511  1  1  1  
1  1.19704  1  1  1  
1  1.03357  1  1  1  
1  1.07597  1  1  1  
1  1.03109  1  1  1  
1  1.42696  1  1  1  
1  1.00709  1  1  1  
1  1.00481  1  1  1  
