1.00014  2.99976  2.9863  1.00013  3  
1  1  1  1  1.0039  
1  1.71152  1  1  1  
1  3  2.48664  1  1  
1  3  1  1  1  
1  3  2.37241  1  1  
1  2.84714  1  1  1  
1  3  1  1  1  
1  2.8844  1  1  1  
1  3  2.42423  1  1  
1  2.40674  1  1  1  
1  2.92934  1  1  1  
1  2.51802  1  1  1  
1  3  1  1  1  
1  2.27851  1  1  1  
1  2.96632  1  1  1  
1  2.46586  1  1  1  
1  3  2.47759  1  1  
1  1.87216  1  1  1.08469  
1  2.47926  1  1  1  
1  2.117  1  1  1  
1  2.9893  1  1  1  
1  1.93998  1  1  1  
1  2.57161  1  1  1  
1  2.12038  1  1  1  
1  3  1.89013  1  1  
1  1.78537  1  1  1  
1  2.30801  1  1  1  
1  1.93546  1  1  1  
1  2.98286  1  1  1  
1  1.77789  1  1  1  
1  2.47013  1  1  1  
1  1.97238  1  1  1  
1  3  2.47137  1  1  
1  1.28875  1  1  1.1859  
1  1.95967  1  1  1  
1  1.68673  1  1  1  
1  2.43927  1  1  1  
1  1.57175  1  1  1  
1  2.06581  1  1  1  
1  1.71056  1  1  1  
1  2.9202  1  1  1  
1  1.47947  1  1  1  
1  1.86517  1  1  1  
1  1.58842  1  1  1  
1  2.46167  1  1  1  
1  1.48204  1  1  1  
1  2.00426  1  1  1  
1  1.62093  1  1  1  
1  3  1  1  1  
1  1.36583  1  1  1  
1  1.66332  1  1  1  
1  1.44844  1  1  1  
1  2.12296  1  1  1  
1  1.36553  1  1  1  
1  1.76267  1  1  1  
1  1.46902  1  1  1  
1  2.74665  1  1  1  
1  1.30075  1  1  1  
1  1.59278  1  1  1  
1  1.37752  1  1  1  
1  2.17685  1  1  1  
1  1.30074  1  1  1  
1  1.71275  1  1  1  
1  1.39857  1  1  1  
1  3  2.17702  1  1  
1  1.00484  1  1  1.1113  
1  1.37279  1  1  1  
1  1.24766  1  1  1  
1  1.63065  1  1  1  
1  1.19758  1  1  1  
1  1.41332  1  1  1  
1  1.24893  1  1  1  
1  1.94806  1  1  1  
1  1.15497  1  1  1  
1  1.30308  1  1  1  
1  1.18924  1  1  1  
1  1.58715  1  1  1  
1  1.14551  1  1  1  
1  1.33942  1  1  1  
1  1.18532  1  1  1  
1  2.17508  1  1  1  
1  1.09703  1  1  1  
1  1.1836  1  1  1  
1  1.11344  1  1  1  
1  1.32919  1  1  1  
1  1.08335  1  1  1  
1  1.18409  1  1  1  
1  1.09903  1  1  1  
1  1.5255  1  1  1  
1  1.05323  1  1  1  
1  1.10472  1  1  1  
1  1.05718  1  1  1  
1  1.20445  1  1  1  
1  1.03483  1  1  1  
1  1.07883  1  1  1  
1  1.03225  1  1  1  
1  1.44302  1  1  1  
1  1.00735  1  1  1  
1  1.00499  1  1  1  
